足	ソク	あし　た-りる　た-す	jalka, pari
文	ブン　モン	-	kaava, kirjain, lause
低	テイ	ひくーい	matala
飲	イン	のーむ	juoda
見	ケン	みーる, みーえる, みーせる	nähdä, katsoa
話	ワ	はなーす, はなし	puhua
教	キョウ	おしーえる	opettaa, ohjata, uskonto
Lesson 10
昼	チュウ	ひる	keskipäivä, päiväsaika
夜	ヤ	よる, よ	ilta/yö
晩	バン	-	ilta/yö
夕	-	ゆう	ilta
午	ゴ	-	keskipäivä
前	ゼン	まえ	ennen, edessä, aiempi
後	ゴ, コウ	あと, うしーろ	jälkeen, myöhemmin, takana, taka-
週	シュウ	-	viikko
曜	ヨウ	-	viikonpäivä
待	タイ	まーつ, まち	odottaa, vieraanvaraisuus
言	ゲン, ゴン	いーう, こと	sanoa
計	ケイ	-	mitta
語	ゴ	-	sana, kieli
飯	ハン	めし	keitetty riisi, ateria, ruoka
Lesson 12
宅	タク	-	talo, koti, residenssi
客	キャク	-	vieras, asiakas
室	シツ	-	huone
薬	ヤク, ヤッ	くすり	lääke
会	カイ	あーう	tapaaminen, järjestö
今	コン	いま	nyt, tämänhetkinen
雪	-	ゆき	lumi
雲	-	くも	pilvi
電	デン	-	sähkö
売	バイ	うーる	myydä
Lesson 13
広	コウ	ひろーい	laaja, avara
度	-	ど	aste, frekvenssi
病	ビョウ	-	sairas
疲	-	つかーれる	uupua
痛	ツウ	いたーい, いたーむ	kipu
屋	オク	や	katto, kauppa, talo
回	カイ	まわーる, まわーす	kääntyä, kierros
困	コン	こまーる	ongelma
開	カイ	あーく, あーける, ひらーく	avata
閉	ヘイ	しーまる, しーめる, とーじる	sulkea
Lesson 14
近	キン	ちかーい	near, recent
遠	エン	とおーい	far, remote
速	ソク	はやーい	speedy
遅	チ	おそーい, おくーれる	slow, late
道	ドウ	みち	street, way
晴	セイ	はーれる, はーれ	fine, clear up
静	セイ	しずーかな	silent, still
持	ジ	もーつ	hold
Lesson 15
妻	サイ	つま	wife
彼	-	かれ, かの	hän
主	シュ	おもーな, ぬし	chief, main, lord, owner
奥		おく	deep, inside, interior
名	メイ	な	nimi, kuuluisa, jäsenet
親	シン	おや, したーしい	vanhempi, sukulaisuus
切	セシ	きーる, きっ	leikata, lopettaa, moderate
便	ベン, ビン	-	tämänhetkinen, liikenne, mukavuus
利	-	り	tuotto, tuottoisa
若	-	わかーい	nuori
忙	ボウ	いそがーしい	kiireinen
Lesson 17
出	シュツ, シュッ	でーる, だーす	tulla/mennä ulos
乗	ジョウ	のーる, のーせる	matkustaa
降	コウ	おーりる, ふーる, おーろす		laskeutua
着	チャク	つーく, きーる	saapua, saavuttaa, pukea
渡	ト	わたーる, わたーす	ristetä
通	シウ	とおーる, かよーう, とおーす	pass, commute (?)
走	ソウ	はしーる	juosta
歩	ホ, ポ	あるーく	kävellä
止	シ	とーまる, とーめる	pysähtyä
動	ドウ	うごーく, うごーかす	liikkua
働	ドウ	はたらーく	työskennellä
内	ナイ	うち	sisä-, sisällä, sisempi
部	ブ	へ	osasto, osa, klubi(club)
社	シャ, ージャ	-	shintopyhäkkö, yritys, yhdistys
院	イン	-	instituutio, laitos
地	ジ, チ	-	ground, base
場	ジョウ	ば	place, scene
図	ズ, ト	-	diagram, devise
公	コウ	-	public, official
住	ジュウ	すーむ	dwell, inhabit
所	ショ, ージョ	ところ	place, that which
番	バン	-	number, order
号	ゴウ	-	call, naming, [suffix] order
市	シ	いち	city, market
町	チョウ	まち	town
村	ソン	むら	village
都	ト	-	capital, big city, tokyo
府	フ	-	administrative, prefecture
県	ケン	-	prefecture
様	ヨウ	さま	appearance, mr. mrs. miss
Lesson 21
練	レン	-	knead
習	シュウ	ならーう	practice
勉	ベン	-	endeavor
強	キョウ	つよーい	force, strong
研	ケン	-	grind, sharpen
究	キュウ	-	to carry to, extremity
留	リュウ	とーまる, とーめる	stay, detain
質	シツ	-	quality, question
問	モン	とーう, とい	inquire, question
題	ダイ	-	title, theme
答	トウ	こたーえる, こたえ	answer
宿	シュク	-	lodging, dwelling
Lesson 22
政	セイ	-	hallinto
治	ジ	おさーまる, おさーめる, なおーる, なおーす	hallita
経	ケイ	-	kontrolloida, päästä läpi
済	サイ, ザイ	-	lopettaa
歴	レキ	-	ura
史	シ	-	historia
育	イク	そだーつ, そだーてる	kasvattaa
科	カ	-	haara
数	スウ	かず, かぞーえる	numero, muutama
医	イ	-	lääkäri
Lesson 23
映	エイ	うつーる, うつーす	heijastaa
画	ガ, カク	-	kuva, kanjin vedot
写	シャ	うつーる, うつーす	kopioida, projektoida
真	シン	ま	oikea, aito, juuri, tietty
楽	ガク, ラク	たのーしい, たのーしむ	musiikki, hauskuttaa, miellyttää
料	リョウ	-	ainekset, taksa
組	ソ	くーむ, くみ, －ぐみ	yhdistää, ryhmä
思	シ	おもーう	ajatella, fancy(?)
色	ショク	いろ	väri, ominaisuus
Lesson 24
起	キ	おーきる, おーこす, おーこる	nousta, tehdä aloite
寝	シン	ねーる, ねーかす	nukkua
遊	ユウ	あそーぶ	leikkiä, vaellella
立	リツ	たーつ, たーてる	seistä, establish (?)
座	ザ	すわーる	istua
使	シ	つかーう	käyttää
始	シ	はじーまる, はじーめる	alkaa
終	シュウ	おーわる, おーえる	loppua